@@@@@@@@@@@@@@@@@@@@@@@@@@@@@@@@@@@@@@@@@@@@@@@@@@@@@@@@@@@@@@@@@@@@@@@@@@@@@@@@@@@@@@@@@@@@@@@@@@@@@@@@@@@@@@@@@@@@@@@@
@         @                    @                  @                                      @                             @
@         @                    @                  @           @                          @                             @
@         @       @            @                  @           @                          @                             @
@         @       @                     @         @           @                          @                             @
@                 @     ?               @                     @@@@@@@@                   @                             @
@                                       @                                                @         ?        @          @
@             @                         @               @                                @                  @          @
@             @                         @               @                     @                             @          @
@                                       @                                     @                                        @
@                       @               @                                     @                                        @
@   @                   @               @                      #              @             @@@@@@@@@@@                @
@   @                   @                           @                         @                       @                @
@   @                   @                           @                                                 @                @
@   @                   @                           @                                                 @                @
@            @                                      @         @                           #           @                @
@            @                @          @                    @                                       @                @
@            @                @          @                                                            @                @
@       #    @                @          @                                                @                            @
@                             @                                     @@@@@@@@@@@@          @                            @
@                             @                #                                          @                            @
@                     @@@@    @                                               ?           @                            @
@                             @                                                           @                            @
     +                        @                       @                                   @                             
@                 @           @                       @                                                                @
@                 @   ?       @    ?                  @                                                                @
@                 @           @                       @                                                                @
@                 @           @                       @                                                   @@@@@@@@@    @
@                             @                       @                                                                @
@@@@@@@@@@@@@@@@@@@@@@@@@@@@@@@@@@@@@@@@@@@@@@@@@@@@@@@@@@@@@@@@@@@@@@@@@@@@@@@@@@@@@@@@@@@@@@@@@@@@@@@@@@@@@@@@@@@@@@@@